1,2,2,2,2,2,2,2,2,2,2,2,2,2,2,2,2,4
17,0,0,70,0,0,0,0,0,0,0,0,0,0,0,0,0,20
17,0,0,0,0,0,0,0,0,0,0,0,0,0,0,0,0,20
17,0,0,0,69,0,0,0,0,0,0,69,0,0,0,0,0,20
17,0,0,0,0,0,0,0,0,0,0,0,0,0,0,0,0,20
17,0,0,0,0,0,70,0,0,0,0,0,70,0,0,0,0,20
17,0,0,0,70,0,0,85,0,0,0,0,0,0,0,0,0,20
17,0,0,0,0,0,0,0,0,0,0,0,0,0,0,0,0,20
33,2,2,2,2,2,2,2,2,2,2,2,2,2,2,2,2,36